..................
................
..#...........#.
..........#.....
......#....#..#.
....#...........
.......@........
............#...
..#.....#.......
......#.........
.........#......
......#.....#...